########################
#                      #
#                      #
#                      #
#                      #
#                      #
#                      #
#                      #
#                      #
#                  
#                  
#                    ###
#                    ###
#             ##########
#             ##########
#      D##    ##########
#S     ###   ###########
##########   ###########