####################
#                  #
#                  #
#                  #
#                  #
#                  #
#                  #
#                  #
#                   
#                   
#            #######
#            #######
#      #############
#S     #############
####################