####################
#                  #
#                  #
#                  #
#                  #
#                  #
#                  #
#                  #
#        C           
#                   
#            #######
#            #######
#      ##   ########
#S     ##  #########
#########  #########