####################
#                 ##
#                 ##
#                 ##
#                 ##
#                 ##
#                 ##
#                 <#
                  <#
 S                <#
######            ##
######            ##
######            G
######            G
####################