########################
#                     ##
#                     ##
#                     ##
#                     ##
#                     ##
#                     ##
#                     ##
#                     <#
                      <#
 S                    <#
######                ##
######                ##
######                X
######                X
######                X
########################
########################