########################
#                    ###
#                    ###
#                    ###
#                    ###
#                    ###
#                    ###
#                    ###
#                    <##
                     <##
 S                   <##
######               ###
######               ###
######               X
######               X
######               X
########################
########################