
#########vv#############
#          W          X
#          W          X
#          W          X
#          W ###########
#          W ###########
#          W ###########
#         ##############
#         ##############
#         ##############
#WWWWWW#################
#      #################
#      #################
    ####################
    ####################
    ####################
########################