##################vv####
               W    <###
               W    <###
               W    ####
 S             W    ####
#######X ###   W    ####
#######  ###   W    ####
#######  ###   W    ####
####### X###   W    ####
#######  ###   W    X
#######  ###   W    X
#######X ###   W    ####
#######  ###   W    ####
#######  ###   W    ####
####### X###   W    ####
#######        W   
#######        W  
########################