########################
#MMMMMMMMMMMMMMMMMMMMM##
#M                   M##
#M                   M##
#M  MMMMMMMMMMMMMMM  M##
#M  M#>X             M##
#M  M#>X             M##
      MMMMMMMMMMMMMMMM##
 S          ############
#####       ####
###>Y       ####
###>Y       ####
###D        X Y
########################
########################
########################
########################
########################