########################
#MMMMMMMMMMMMMMMMMMMMM##
#M                   M##
#M                   M##
#M  MMMMMMMMMMMMMMM  M##
#M  M#>X             M##
#M  M#>X             M##
      MMMMMMMMMMMMMMMM##
 S    ##################
#####   X Y
###>Y   X Y
###>Y   X Y
###D    X Y
########################
########################
########################
########################
########################