########################
#     <#################
#     <#################
#     <#################
#                      #
#                      #
M                      #
M                      #
M                      #
#                      #
#                      #
#                      #
#                     ##
                      X
                      X
 S                    X
########################
########################