####################
#     <#############
#     <#############
#     <#############
#                  #
#                  #
#                  #
#                  #
#                  #
#                  #
#                  #
#                 ##
                  G
                  G
####################