####################
#     <#############
#     <#############
#     <#############
#                  #
#                  #
M                  #
M                  #
M                  #
#                  #
#                  #
#                 ##
                  X
 S                X
####################