########################
##MMMMMMMMMMMMMMMMMMMMM#
##M                   M#
##M                   M#
##M   MMMMMMMMMMMMMM  M#
  M   M#>             M#
# M   M#>             M#
#      MMMMMMMMMMMMMMMM#
# S    #################
#####      X Y X     ###
###>Y      X Y X     ###
###>Y      X Y X     ###
###D       X Y X     ###
#################### ###
#################### ###
#################### ###
#################### ###
#################### ###