########################
########################
########################
########################
########################
               #########
#########      #########
#########      #########
#########      #########
#########      #########
#########      #########
#########      
#########     K
########################
########################
########################
########################
########################