########################
##             #########
##               
##               
##             #########
##             #########
##             #########
##             #########
##             #########
##             #########
##             #########
               #########
 S             #########
###            #########
###            #########
###            #########
###DDDDDDDDDDDD#########
########################