########################
########################
    ####################
 S  ####################
##  ####################
##  ####################
##  ####################
##  ####################
##  ####################
##  ####################
##  ####################
##  ####################
##  ####################
##  MMMMMMM#############
##             
##  MMMMMMM###
##  ####################
##  ####################