####################
#                  #
#  # # # ###  ###  #
#  # # #  #   # #  #
#  # # #  #   ###  #
#   # #   #   #    #
#   # #  ###  #    #
#                  #
#                  #
#                  #
#                  #
#                  #
                   #
                   #
####################