##########vv########
#                  G
#                  G
#                  G
#          #########
#          #########
#        ###########
#        ###########
#      #############
#      #############
#    ###############
#    ###############
   #################
 S #################
####################