##########vv############
#                     X
#                     X
#                     X
#            ###########
#            ###########
#            ###########
#         ##############
#         ##############
#         ##############
#      #################
#      #################
#      #################
#   ####################
    ####################
    ####################
########################
########################