######MMM###########
                   X
                   X
 S                 X
##M  ###############
##M  DDD############
##M   DD############
##DD   DD###########
###DD   DD##########
####DD   DD#########
#####DD   DD########
######DD   DD#######
#######DD   DD######
########DD   D######
##########^^^#######