#######MMM##########
                   G
                   G
 S                 G
###  ###############
##M  DDD############
##M   DD############
##DD   DD###########
###DD   DD##########
####DD   DD#########
#####DD   DD########
######DD   DD#######
#######DD   DD######
########DD   D######
##########^^^#######