####################
                   G
                   G
 S                 G
#  ########
##########    ######
##########    ######
#             ######
#             ######
#             ######
#             ######
#             ######
#                  #
#                  #
####################