######MM####MMMM####
     g           ###
     g           M##
 S   g           M##
#XX######MM    MM###
#  ####vv#M    #####
#  ###M  ##    #####
#  ###M  ##    #####
#  ####  M#    M####
#  ####  M#    M####
#  ###M  ##    #####
#  ###M  ##gggg#####
#            Y      
#            Y      
#########MM#########