########MM####MMMM##MM##
      g               M#
      g               M#
 S    g               ##
#XX## g ###MM    MMMM###
#  ######vv#M    #######
#  #####MYY##    #######
#    ###M  ##    #######
#    ####  M#    M######
#    ####  M#    M###M##
#    ###M  ##          <
#    ###M  ##          <
#    ####        ##M####
#    ####        #######
#    ######MMgggg#######
#                    Y 
#                    Y
########################