######MM####MMMM####
     g           ###
     g           M##
 S   g           M##
#GG######MM    MM###
#  ####vv#M    #####
#  ###M  ##    #####
#  ###M  ##    #####
#  ####  M#    M####
#  ####  M#    M####
#  ###M  ##    #####
#  ###M  ##gggg#####
#                   
#                   
#########MM#########