####################
#                  #
#                  #
#                  #
#          M       #
#          M       #
#          M       #
#          #       #
#          #       #
#          G        
#          G        
#          G
# ######   #########
 S######DDD#########
####################