####################
#          X       #
#          X       #
#          X       #
#          X       #
#######>   X       #
#######>   X       #
#######>   X       #
#          X       #
#          X       Y
#          X       Y
#          X       Y
# ######   #   #####
 S######DDD#DDD#####
####################