####################
>          G        
>          G        
>          G        
#          ####  ###
#          ####  ###
#     GG   ####  ###
#          ####  ###
#          ####  ###
    GG     ####  ###
           ####  ###
 S         ####  ###
######     ####  ###
######DDDDD####  ###
###############  ###