####################
>          X        
>          X        
>          X        
#          #########
#          ##### 
#     XX   #####   #
#          ##### C #
#          #####   #
    XX     #########
           #########
 S         #########
######     #########
######DDDD  ########
########### ########