####################
           G        
           G        
 S          G        
####################
#          ####  ###
#     GG   ####  ###
#          ####  ###
#          ####  ###
    GG     ####  ###
           ####  ###
 S         ####  ###
######     ####  ###
######DDDDD####  ###
###############  ###