####################
            ########
            ########
 S          ########
## #        ########
   #        ########
   #        ########
 # #        ########
   #        ########
###         ########
##          ########
##          ########
##          ########
##          ########



####################