########################
            ############
            ############
 S          ############
## #        ############
   #        ############
   #        ############
 # #        ############
   #        ############
###         ############
##          ############
##          ############
##          ############
##          ############



########################