#########  #########
#                  #
#        S         #
#        ##        #
#           #      #
#                  #
#             #    #
#                  #
#   BB   WW     #  #
#                  #
#                  #
#  gg   ##   MM  vv#
#                  #
#                 G#
#D##################