#########  #########
#                  #
#        S         #
#        ##        #
#           #      #
#                  #
#             #    #
#                  #
#   BB   WW     #  #
#                  #
#                vv#
#  gg   ##   MM    #
#                 Y#
#                 X#
#D##################