#########  #########
#                  #
#                  #
#        ##        #
#           #      #
#                  #
#             #    #
#                  #
#   BB   WW     #  #
#                  #
#                  #
#  gg   ##   MM    #
#                  #
#                  #
####################