##########   ###########
#                      #
#         S            #
#         ###          #
#                      #
#           ##         #
#                      #
#             #        #
#                      #
#   BB   WW     #      #
#                      #
#  gg   ##   MM   #    #
#                    vv#
#                      #
#####  C             Y #
#                      #
#          P          X #
#D######################