#################### ###
#                    ###
# #################  ###
# #                #####
# # 
# #               vv####
# #                    #
# #          YY        #
# #                    #
# #      XX            #
# #                    #
#    MM                #
#                      #
# S                    #
#####                  #
#####                  #
#####DDDDMMDDDDDDDDDDDD#
########################