##  ####################
##SSMMDDMMDDMMDDMM######
##                <#####
##                <#####
##  DDMMDDMMDDMMDD######
#M  ####################
#M  ####################
##  ####################
##  ####################
##  ####################
## #####################
##  ####################
##  ####################
### DDMMDDMMDDMMDDMMDD##
##  XXXXXXXXXXXXXXXXXX
##  XXXXXXXXXXXXXXXXXX
####MMDDMMDDMMDDMMDDMM##
########################
########################