########################
#MMMMMMMMMMMMMMMMMMMMM##
#>         M         <##
#>         M         <##   
##MMMMMMM  M  MMMMMMMM##
##         M          ## 
##         M          ##
##         X          ##
##         X          ##
##        ###         ##
##       D # D        ##
##      D  #  D       ##
##     D   #   D      ##
      D    #    D     Y
 S   D     #     D    Y
########################
########################
########################