########################
########################
########################
########################
#########vvv############
#           XD    ######
#           XD    vvv###
            XD       Y
            XD       Y
            X        Y
            X        Y
            X        Y
            X        Y
            X        Y
 S          X        Y
##XXXXXXXXXXXXXXXXXXX###
##DDDDDDDDDDDDDDDDDDD###
########################
