########### ########
##########   #######
#########     ######
########       #####
#######         ####
######           ###
#####             ##
####               #
###
###
###
###
###
###        S
####################