########################
#                      #
#                      #
#                      #
#                      #
#                      #
#                      #
#                      #
#                      #
#                  
#                  
#                    ###
#                    ###
#             ##########
              ##########
       D##    ##########
 S     ###   ###########
##########   ###########