##################vv####
               W    <###
               W    <###
               W    ####
 S             W    ####
#######Y ###   W    ####
#######  ###   W    ####
#######  ###   W    ####
####### Y###   W    ####
#######  ###   W    Y
#######  ###   W    Y
#######Y ###   W    ####
#######  ###   W    ####
#######  ###   W    ####
####### Y###   W    
#######        W   
#######        W  
########################