########################
#MMMMMMMMMMMMMMMMMMMMM##
#M                   M##
#M                   M##
#M  MMMMMMMMMMMMMMM  M##
#M  M#>Y             M##
#M  M#>Y             M##
      MMMMMMMMMMMMMMMM##
 S    ##################
#####W##################
###>X     Y X 
###>X     Y X 
###D      Y X 
########################
########################
########################
########################
########################