########################
#                    ###
#                    ###
#                    ###
#                    ###
#                    ###
#                    ###
#                    ###
#                    <##
                     <##
 S   p               <##
######               ###
######               ###
#########            X
#########            X
#########            X
########################
########################