###MMMMMMMMMMM##########
###M                ####
###M                ####
###M                ####
###M                ####
###M                ####
###M           D    ####
               <    ####
 S             <    ####
###XXX         <    ####
#                   ####
#                   ####
#                   ####
#           YYY
#
#                  #####
#DDDDDDDDDDDDDDDDDD#####
########################