########################
#     <#################
#     <#################
#     <#################
#                      #
#                      #
M                      #
M                      #
M                      #
#                      #
#                      #
#                      #
#                    ###
                     Y
                     Y
 S                   Y
########################
########################