########################
##MMMMMMMMMMMMMMMMMMMMM#
##M                   M#
##M                   M#
##M   MMMMMMMMMMMMMM  M#
  M   M#>             M#
# M   M#>             M#
#      MMMMMMMMMMMMMMMM#
# S    #####DDD#########
#####      Y X Y     ###
###>X      Y X Y     ###
###>X      Y X Y     ###
###D       Y X Y     ###
#################### ###
#################### ###
#################### ###
#################### ###
#################### ###