########################
########################
########################
########################
########################
########################
########################
########################
########################
#              #########
#              #########
#              
#            P 
###   ##################
### ####################
### ####################
##  ####################
## #####################