########################
########################
########################
########################
########################
########################
########################
########################
########################
###            #########
###            #########
###            
###    S    P 
###   ##################
### ####################
##  ####################
##  ####################
## #####################