########################
########################
    ##########
 S  ######### 
##  ########         ###
##  #######          ###
##  ######       #######
##  #####        #######
##  ####         #######
##  ###          #######
##  ##           #######
##  #            #######
##               ####### 
##               #######  
##               #######   
##               #######   
##DDDDDDDDDDDDDDD#######
########################