########################
#####MMMMMMMMMMMMMMMMMM#
#####M                <#
#####M                <#
#####M  MMMMMMMMMMMMMMM#
#####M  M#   
#####M  M#             #
#####M  M#           XX#
#####M  M#    XX       #
###  W            YY   #
###  W                 #
###  MMMMMMMMDDDDDDDDDD#
###  ###     ###########
###  # g     ###########
###YY# g  #  <##########
 S     g  #  <##########
########################
########################