########################
########################
    ####################
 S  ####################
##  ####################
##  ####################
##  ####################
##  ####################
##  ####################
##  ####################
##  ####################
##  ####################
##  ####################
##  MMMMMMMMMMMMMMM#####
##                 c####
##  MMMMMMMMMMMMMMM#####
##  ####################
##  ####################