##########vv############
#                    X
#                    X
#                    X
#            ###########
#            ###########
#            ###########
#         ##############
#         ##############
#         ##############
#      #################
#      #################
#      #################
    ####################
    ####################
 S  ####################
########################
########################