######MMM###############
                     X
                     X
 S                   X
##M  ###################
##M  DD#################
##M   DD################
##DD   DD###############
###DD   DD##############
####DD   DD#############
#####DD   DD############
######DD   DD###########
#######DD   DD##########
########DD   DD#########
#########DD   DD########
##########DD   D########
###########D^^^D########
########################