######MMM###############
                     Y
                     Y
 S                   Y
##M  ###################
##M  D##################
##M   D#################
###D   D################
####D   D###############
#####D   D##############
######D   D#############
#######D   D############
########D   D###########
#########D   D##########
##########D   D#########
###########D   D########
############^^^#########
########################