######MMM###############
                     X
                     X
 S                   X
##M  ###################
##M  D##################
##M   D#################
###D   D################
####D   D###############
#####D   D##############
######D   D#############
#######D   D############
########D   D###########
#########D   D##########
##########D   D#########
###########D   D########
###########D^^^D########
########################