#vvv####################
#              Y        
#              Y        
#              Y        
#              #########
#              ##### 
#         YY   #####   #
#              ##### C #
#              #####   #
        YY     #########
               #########
               #########
    YYYY       #########
               #########
 S             #########
###            #########
###DDDDDDDDDD#  ########
############### ########