########################
>              X        
>              X        
>              X        
#              #########
#              ##### 
#         XX   #####   #
#              ##### C #
#              #####   #
        XX     #########
               #########
               #########
    XXXX       #########
               #########
 S             #########
###            #########
###DDDDDDDDDD#  ########
############### ########