########################
  

 S
v#v#v#v#v#v#v#vvvvvvvvvv

#
#
#                 
#YY  XX  YY  XX  YY  ###
#DDDDDDDDDDDDDDDDDDDD###
########################
########################
########################
##
##
##
##  ####################