########################
                ########
                ########
 S              ########
## ##########   ########
   ##########   ########
   ##########   ########
 # #       ##   ########
   #       ##   ########
###        ##   ########
##         ##   ########
##     ##  ##   ########
##     ##  ##   ########
##   ####  ##   ########
     ####
   ######
   ######
########################