########################
#MMMMMMMMMMMMMMMMMMMMM##
#>         M         <##
#>         M         <##   
##MMMMMMM  M  MMMMMMMM##
##         M          ## 
##         M          ##
##         Y          ##
##         Y          ##
##        ###         ##
##       D # D        ##
##      D  #  D       ##
##     D   #   D      ##
      D    #    D     X
 S   D     #     D    X
########################
########################
########################