#################### ###
#                    ###
# #################  ###
# #                #####
# # 
# #               vv####
# #                    #
# #          YY        #
# #                    #
# #      XX            #
# #          DD        M
#    MM      MM        M
#                      #
# S                    #
#####                  #
#####                  #
#####DDDDMMDDDDDDMMDDDD#
########################