#############    #######
############      ######
###########        #####
##########          ####
#########            ###
########              ##
#######                #
######              
######        
######         
######          
######           
######
######                
######
######
######
########################