##  ##########vvvvvv####
##                  <###
####  C             <###
##########          <###
##########          <###
##########XXX       <###
                    <###
           YYY      <###
                    <###
            XXX     <###
                    <###
             YYY    <###
                    <###
              XXX   <###
                    <###
               YYY  <###
 S                  <###
########################