##  ##########vvvvvv####
##                  <###
####  C             <###
##########          <###
##########          <###
##########YYY       <###
                    <###
           XXX      <###
                    <###
            YYY     <###
                    <###
             XXX    <###
                    <###
              YYY   <###
                    <###
               XXX  <###
 S                  <###
########################