########################
#                      #
#                      #
#                      #
#                      #
#                      #
#                      #
#                      #
#                      #
#                      #
#                      #
#                      #
#                      #
#                      #
#                      #
#                      #
#       S              #
##     #################